00000000000000000000000000000000000000000000000000000000000000000000000000
00000000000000000000111111000000000000000000000000000000000000000000000000
00000000000000000000122223333333333333330000000000000000000000000000000000
00000000000000000000122221000000000000331111111111110000000000000000000000
00000000000000000000122221000000000000333222222222210000000000000000000000
00000000000000000000122221000000000000331222222222210000000000000000000000
00000000000000000000122221000000000000331222222222210000000000000000000000
00000000000000000000111311000000000000331222222222210000000000000000000000
00000000000000000000000300000000000000331222222222210000000000000001111110
00000000000000000000000333333300000000331222222222233333330000000001222210
00000000000000000000000001111311111100331111111113110000030000000001222210
00000000000000000000000001222222222100330000000003000000030111111033222210
00000000000000000000000001222222222100330000000003000000030122221031222210
00000000000000000000000001222222222100330000000003000000030122223331222210
00000000000000000000000001222222222333330000000003000000030122221001222210
00000000000000000000000001111113111100330000000003000000033322221001222210
00003333333333333333333333333333000000330000000003000000030122221001222210
00003000000000000000000000000030000000330000000003000000030122221001222210
00013111110000000000000000000030000000330000000003000000030122221001222210
00012222210000000000000000000030000000330000000003333000030122221001222210
00012222210000000011111111111131111000330000000000003000030122221001111110
00012222210000000012222222222222221000330000000000003000030122221000000000
00012222210000000012222222222222221000330000000000003000030122221000000000
00012222210000000012222222222222221000330000000000003000030122221000000000
00012222233333333312222222222222221000330000000000003000030111111000000000
00012222210000000312222222222222221000330000000001113111030000000000000000
00011111110000000312222222222222221000330000000001222221030000000000000000
00000000000000000312222222222222221000330000000001222221030000000000000000
00000000000000000332222222222222223333333333333333222221030000000000000000
00000000000000000012222222222222221000000000000001222221030000000000000000
00000000000000000011111111111111111000000000000001222221030000000000000000
00000000000000000000000000000000000000000000000001222223330000000000000000
00000000000000000000000000000000000000000000000001111111000000000000000000
00000000000000000000000000000000000000000000000000000000000000000000000000
