30000000000000000000000000000000000000000000000000000000000000000000000000
00000000000000011111100000000000000000000000000000000000000000000000000000
00000000000000012222100000000000000000000000000001111111000000000000000000
00000000000000012222333333333333333333300000000001222221000000000000000000
00000000000000012222100000000000000000300000000001222221000111111111110000
00000000000000012222100000000000000000300000000001222221000122222222210000
00000000000000012222100000000000000000300000000033222223300122222222210000
00000000000000011311100000000000000000300000000031222221333322222222210000
00000000000000000300000000000000000000311111100031111111300122222222210000
00000000000000333300000000000000000000312222100030000000300122222222210000
00000000011111311111111110000000000000312222333330000000300122222222210000
00000000012222222222222233333333333333312222100000000000300122222222210000
00000000012222222222222210000000000000332222100000000000300122222222210000
00000000012222222222222210000000000000012222100000000000300111111311110000
00000000012222222222222210000000000000012222100000000000300000000300000000
00000000012222222222222210000000000000011111100000000000300000000300000000
00000000011111111111311110000000000000000000000000000000300000000300000000
00000000000000000000300000000000000000000000000000000000300003333300000000
00033333333333333333333333300000000000000000000000000000300003000000000000
00030000000000000000000000300000000000000000000000000000300003000000000000
00030000000000000000000000300000000000000000000000000000300003000000000000
00030000000000000000000001311111000000000000000000000000300113111111110000
00030000000000000000000001222221000000000000000000000000300122222222210000
00030000000000000000033333222221000000000000000000000000300122222222210000
00030000000000000000030001222223333333000000000000000000300122222222210000
00030000000000000000030001222221000000000000000000000000300122222222210000
01131111111100000000030001222221000000000000000000000000333322222222210000
01222222222100000000030001222221000000000000000000000000000122222222210000
01222222222333333333330001222221000000000000000000000000000111111111110000
01222222222100000000000001222221000000000000000000000000000000000000000000
01222222222100000000000001111111000000000000000000000000000000000000000000
01222222222100000000000000000000000000000000000000000000000000000000000000
01111111111100000000000000000000000000000000000000000000000000000000000000
00000000000000000000000000000000000000000000000000000000000000000000000000
