00000000000000000000000000000000000000000000000000000000000000000000000000
00000000000000000000000000000000000000000000000000000000000000000000000000
00000000000000000000000000000000000000000000000000111111111111110000000000
00000000000000000000000000000000000000000000000000122222222222210000000000
00000000000000000000000000000000000000000000000000122222222222210000000000
00000000000000000000000000000000000000000000000000122222222222210000000000
00000000000000000000000000000000000333333333333333322222222222210000000000
00000000000000000000000000000000000300000000000000122222222222210000000000
00000000000000000000000000000000000300000000000000122222222222210000000000
00000000000000000000000000000000000300000000000000122222222222210000000000
00000000000000000000000000000000000300000000000000122222222222210000000000
00000000000000000000000000000000000300000000000000122222222222210000000000
00000000001111110000000000000000000300000000000000122222222222210000000000
01111100001222233330000000000000000300000000000000122222222222210000000000
01222100001222210030000000000000000300000000000000111113111111110000000000
01222100001222210030000000111111111300000000000000000003000000000000000000
01222100001222210030000000122222221300000000000000000003333333333300000000
01222100001222210030000000122222221300000000000000000000000001111311111000
01222103333222210030000000122222221300000000000000000000000001222222221000
01222333001222210030000000122222221333333333333333333333333333222222221000
01222100001111110030000000122222221300000000000000000000000001222222221000
01111100000000000030000000122222221300000000000000000000000001222222221000
00000000000000000030000000122222221300000000000000000000000001111111131000
00000000000000000033333333322222221300000000000000000000000000000000030000
00000000000000000000000000122222221300000000000000000000000000000000030000
00000000000000000000000000122222223300000000000000000000000000000000030000
00000000000000000000000000122222221300000000000333333333333333333333330000
00000000000000000000000000122222221300000000001311111111111110000000000000
00000000000000000000000000122222221300000000001222222222222210000000000000
00000000000000000000000000111111111300000000001222222222222210000000000000
00000000000000000000000000000000000300000000001222222222222210000000000000
00000000000000000000000000000000000333333333333222222222222210000000000000
00000000000000000000000000000000000000000000001111111111111110000000000000
00000000000000000000000000000000000000000000000000000000000000000000000000
