00000000000000000000000000000000000000000000000000000000000000000000000000
00000000000000000000000000000000000000000000000000000000111111000000000000
00000000000000000000000000000000000000000000000000000000122221000000000000
00000000000000000000000000000000000000000000000000000000122221000000000000
00000000000000000000000000000111111333333333333333333333322221000000000000
00000000000000000000000000000122221300000000000000000000131111000000000000
00000000000000000000000000000122223300000000000000000000030000000000000000
00000000000000000000000000000122221300000000000000000000033330000000000000
00000000000000000000000000033322221300000000000000000000000030000000000000
00000000000000000000000000030122221300000000000000000000000030000000000000
00000000000000000000000000030122221300000000000011111111111131000000000000
00000000000000000000000000030122221300000000000012222222222221000000000000
00000000000000000000000000030122221300000000000012222222222221000000000000
01111110000000000000000000030122221300000000000012222222222221000000000000
01222233333333333000000000030122221300000000000012222222222221000000000000
01222210000000003001111110030122221333333333333332222222222221000000000000
01222210000000003001222210030122221300000000000011131111111111000000000000
01222210000000003001222210030122221300000000000000030000000000000000000000
01222210000000003001222210030122221300000000000000033333333333333333333300
01222210000000003001222210030111111300000000000000000000000000000000000300
01222210000000003001222210030000000300000000000000000000000000000000000300
01222210000000003001222233330000000300000000000000000000000000001111111310
01222210000000003001222210000000000333333333333333333333333333333222222210
01222210000000003001222210000000000000000000000000000000000000001222222210
01222210000000003001222210000000000000000000000000000000000000001222222210
01222210000000003001222210000000000000000000000000000000000000001222222210
01222210000000003001222210000000000000000000000000000000000000001222222210
01222210000000003333222210000000000000000000000000000000000000001222222210
01222210000000000001222210000000000000000000000000000000000000001222222210
01111110000000000001222210000000000000000000000000000000000000001222222210
00000000000000000001111110000000000000000000000000000000000000001222222210
00000000000000000000000000000000000000000000000000000000000000001222222210
00000000000000000000000000000000000000000000000000000000000000001111111110
00000000000000000000000000000000000000000000000000000000000000000000000000
