00000000000000000000000000000000000000000000000000000000000000000000000000
00000000000000000000000000000000000000000000000000000000000000000000000000
00000000000000000000000000000000000000000000000000000000000000000000000000
00000000000000000000000000000000000000000000000000000000000000000000000000
00000000000000000000000000000000000000000011111111000000000000000000000000
00000000000000000000000011111111000000000012222221000000000000011111100000
00000000000000003333333332222221000000000012222221000000000000012222100000
00000000000000003000000012222221000000000012222221000000000000012222100000
00000000000000003000000012222221000000000012222221000000000000012222100000
00000000001111113000000012222223333000000012222221000000000000012222100000
00000000001222213000000013111111003000000012222221000003333333332222100000
00000000001222213000000003000000003000000012222221000003000000011131100000
00000000001222213000000003000000003333333332222223333333000000000030000000
00000000001222213000000003000000003300000011111131000000000000000030000000
01111111001222213000000003000000003300000000000030000000000000000030000000
01222221001222213000000003333333003300000000000030000000000000000030000000
01222221001222233000000000000003003300000333333333333333333333333330000000
01222221033222213000111111111113113300111311000000000000000000000000000000
01222221031222213000122222222222213300122221000000000000000000000000000000
01222223331222213000122222222222213300122221000000000000000000000000000000
01222221001222213000122222222222213300122221000000000000000000000000000000
01222221001222213000122222222222213300122221000000000000000000000000000000
01222221001222213000122222222222213333322221000000000000000000000000000000
01222221001222213000122222222222213300113111000000000000000000000000000000
01222221001111113000122222222222213300003000000000000000000000000000000000
01222221000000003000122222222222213300003000000000000000000000000000000000
01222221000000003000122222222222213300003300000000000000000000000000000000
01222221000000003000122222222222213311111311000000000000000000000000000000
01111111000000003333322222222222233312222221000000000000000000000000000000
00000000000000000000122222222222213332222221000000000000000000000000000000
00000000000000000000111111111111110012222221000000000000000000000000000000
00000000000000000000000000000000000012222221000000000000000000000000000000
00000000000000000000000000000000000011111111000000000000000000000000000000
00000000000000000000000000000000000000000000000000000000000000000000000000
